A	AH
A(2)	EY
COMPUTER	K AH M P Y UW T ER
EVERYTHING	EH V R IY TH IH NG
HEAVY	HH EH V IY
HELICOPTER	HH EH L IH K AA P T ER
HELLO	HH AH L OW
HELLO(2)	HH EH L OW
IS	IH Z
MY	M AY
NOT	N AA T
REAL	R IY L
REALITY	R IY AE L AH T IY
REALLY	R IH L IY
REALLY(2)	R IY L IY
ROBOTER	R OW B AA T ER
SO	S OW
STUFF	S T AH F
THINGS	TH IH NG Z
WHAT	W AH T
WHAT(2)	HH W AH T
WHY	W AY
WHY(2)	HH W AY
